#,#,#,#,#
#,.,#,.,#
#,$,#,$,#
#, ,@, ,#
#,$,#,$,#
#,.,#,.,#
#,#,#,#,#