#,#,#,#,F
#,.,#,.,#
#,.,@,$,#
#, ,@, ,#
#,#,#,#,#