#,#,#,#,#
#,.,#,.,#
#,$,#,$,#
#, ,@, ,#
#,#,#,#,#